{
  "1": "ຢ",
  "2": "ຟ",
  "3": "ໂ",
  "4": "ຖ",
  "5": "ຸ",
  "6": "ູ",
  "7": "ຄ",
  "8": "ຕ",
  "9": "ຈ",
  "0": "ຂ",
  "-": "ຊ",
  "=": "ໍ",
  "q": "ົ",
  "w": "ໄ",
  "e": "ຳ",
  "r": "ພ",
  "t": "ະ",
  "y": "ິ",
  "u": "ີ",
  "i": "ຮ",
  "o": "ນ",
  "p": "ຍ",
  "[": "ບ",
  "]": "ລ",
  "\\": "/",
  "a": "ັ",
  "s": "ຫ",
  "d": "ກ",
  "f": "ດ",
  "g": "ເ",
  "h": "້",
  "j": "່",
  "k": "າ",
  "l": "ສ",
  ";": "ວ",
  "'": "ງ",
  "z": "ຜ",
  "x": "ປ",
  "c": "ແ",
  "v": "ອ",
  "b": "ຶ",
  "n": "ື",
  "m": "ທ",
  ",": "ມ",
  ".": "ໃ",
  "/": "ຝ",
  "!": "1",
  "@": "2",
  "#": "3",
  "$": "4",
  "%": "໌",
  "^": "ຼ",
  "&": "5",
  "*": "6",
  "(": "7",
  ")": "8",
  "_": "9",
  "+": "ໍ່",
  "Q": "ົ້",
  "W": "0",
  "E": "*",
  "R": "_",
  "T": "+",
  "Y": "ິ້",
  "U": "ີ້",
  "I": "ຣ",
  "O": "ໜ",
  "P": "ຽ",
  "{": "-",
  "}": "ຫຼ",
  "|": "\\",
  "A": "ັ້",
  "S": ";",
  "D": ".",
  "F": ",",
  "G": ":",
  "H": "໊",
  "J": "໋",
  "K": "!",
  "L": "?",
  ":": "%",
  "\"": "=",
  "Z": "₭",
  "X": "(",
  "C": "ຯ",
  "V": "x",
  "B": "ຶ້",
  "N": "ື້",
  "M": "ໆ",
  "<": "$",
  ">": "ໝ",
  "?": ")"
}
